1111111111111
1C010000000C1
1000011111F01
1P00110000001
1111111111111