1111111111111
1C010000000C1
1000011111F01
100011E000001
1111111111111