1111111111111
1C010000000C1
1000011111F01
1P0011E00P001
1111111111111